10
G.S.W.S.-.-.B.-.-.-
-.-.S.G.-.B.P.BG.-.-
-.S.-.-.G.-.B.-.-.-
S.W.S.-.-.S.-.B.-.-
-.SG.-.-.S.W.BS.P.B.-
-.-.G.-.-.S.-.B.-.-
G.-.-.S.G.-.-.-.B.-
-.-.S.W.S.-.-.B.P.B
G.G.-.S.-.-.-.-.B.-
A.-.-.-.-.G.-.-.-.-