10
G.G.-.-.B.P.B.-.-.G
-.-.-.-.G.BS.-.-.-.-
-.G.-.-.S.W.S.-.-.-
G.B.-.-.G.S.-.-.-.-
B.P.B.G.A.G.-.-.-.-
-.B.P.B.G.-.-.-.-.-
-.-.B.-.S.-.-.B.-.-
G.S.-.SG.GW.S.B.P.B.-
S.W.S.-.S.-.-.B.-.-
G.S.-.-.-.-.-.-.-.G